wrong	correct
Delegate	delegates
ecipse	eclipse
tes	these
sea	noisy
Phnumonia	pneumonia
abo	absorbed
freb	friend
peopel*2	people
airbourne	airborne
aloun	alone
pamphates	pamphlets
contencs	countenance
san_sote	tracksuit
reomentic	romantic
disression	discretion
predadice	prejudice
saund	sound
shesely	scarcely
promest	promised
motiviated	motivated
enginer	engineer
inot	into
fougth	fought
muscels	mussels
agasity	anxiety
buracracy	bureaucracy
congrutulations	congratulations
exstecy	ecstasy
espical	epistle
satisfakson	satisfaction
resoce	resource
continant	continent
everwhere	everywhere
custanemary	customary
delinkquant	delinquent
yonabond	vagabond
dimed	deem
incueds	includes
highdrauwnic	hydraulic
peortry	poetry
saticfacturaly	satisfactorily
wholsome	wholesome
rarther	rather
dickuts	biscuits
anxiousemy	anxiety
erisistable	irresistible
fesctival	festival
telaphone	telephone
predgidice	prejudice
stomo	stomach
aufull	awful
undoubly	undoubtedly
carot	great
thankgiving	thanksgiving
eucuel	equally
concionce	conscience
adviced*2	advised
Phician	physician
couries	curious
defenent	definite
locar	local
symettry	symmetry
auditorum	auditorium
epland	explained
is*2	its
apparient	apparent
lofe	loaf
conciencence	conscientious
specimans	specimens
meloncoly	melancholy
nearse	any
extravagent	extravagant
firery	fiery
secure	schedule
consestane	consistent
dael	deal
sorned	surrounded
sought	sort
atorneys	attorneys
ackcrude	accrued
perlimary	preliminary
pisn	precision
mund	mud
interlect	intellect
tenperary	temporary
magnifsit	magnificent
accomdation	accommodation
life-like	lifelike
dak	back
objet	object
slow	so
desdlition	destination
consencious	conscious
stesticics	statistics
simatry	symmetry
delecate	delicate
agoshion	negotiations
sourse	source
expell	expel
bere_twin	between
murderd	murdered
consentious	conscientious
then	than
deliquant	delinquent
potefl	beautiful
ecconic	economic
temporaly	temporarily
plie	plea
ereplun	aeroplane
bury	buried
sufficiantly	sufficiently
canniballs	cannibals
reverseeasem	enthusiasm
notiesable	noticeable
or	our
flgrcicy	flagrancy
eafter	chapter
theifs	thieves
necessaryily	necessarily
perimete	permanent
gar	jar
hasld	held
elminate	eliminate
bueful	beautiful
case	coarse
sackalliges	sacrilegious
easyly	easily
defanent	definite
bycly	bicycle
off*4	of
cuaritains	curtains
merterly	materially
sam	sure
magnfacant	magnificent
itsself	itself
sperical	spiritual
fanit	fit
conseal	counsel
distrod	destroyed
fasantion	fascination
gernal	colonel
indeqiately	indefinitely
laterst	latest
we	with
hers	hedge
empotly	immediately
inched	instruments
all_wright	all_right
fraturnilly	fraternally
butful	beautiful
seypliment	supplement
patern	pattern
affectioned	affectionate
tournment	tournament
dan	behind
siety	city
doc	back
afanat	accident
complextion	complexion
predict	prejudice
afshionely	affectionately
galpt	galloped
show	should
aprocimately	approximately
mude	mud
strarw	straw
atenment	altimeter
violience	violence
vagenbond	vagabond
schual	schedule
chery	cherry
powing	poems
give	gift
brianer	brainier
af	of
magnifist	magnificent
pokits	pockets
Satuarday	Saturday
cod*3	could
equarly	equally
screem	scream
hase*2	has
imadeatly	immediately
techinial	technical
Consulatoin	?
convelence	convalescence
bullenton	bulletin
spil	spill
Steffen	Stephen
potrre	poetry
kapock	kapok
lise	lies
hapened*2	happened
unfor_geterble	unforgettable
questionare	questionnaire
acheivements	achievements
asstained	ascertain
bing	bring
stading	standing
raed	read
prosesion	precision
lost	lot
ident	indent
skey	scare
depreshtion	depression
meausem	museum
extraordernery	extraordinary
apprechate	appreciate
stingent	stringent
concieved	conceived
evreone	everyone
sow	sew
be	bee
appataters	apparatus
pretennd	pretend
subteranian	subterranean
geve	give
forom	from
imigrated	emigrated
benifit*2	benefit
preblem	problem
subjects	subject
entereny	attorney
aspacelery	especially
ficcilitys	facilities
phanflat	pamphlet
sblled	splendid
trymupt	triumph
headace	headache
minerts	mountainous
refrigerter	refrigerator
disgwished	distinguished
cremistery	chemistry
benificcil	beneficial
is	as
coutsage	curiosity
assemly	assembly
hiting	hitting
unparralleled	unparalleled
properally	properly
salt	suits
neddlework	needlework
countance	countenance
reath	wreath
incased	increasing
resistence	resistance
undividually	individually
oder	odour
conventially	conveniently
tendancy*2	tendency
quereous	curious
permernit	permanent
ecommic	economic
sohe	searched
previlage	privilege
stors	stars
habet	habit
desigened	designed
sombody	somebody
pedels	pedals
hetecoper	helicopter
embasserest	embarrassed
bulletion	bulletin
confidant	competent
brain*2	bran
warkt	walked
partey*2	party
nadar	nadir
rigeosternt	region
knowledgable	knowledgeable
pacific	specific
swich	switch
efficiencely	efficiency
requier	require
triunysh	triumph
arangaments	arrangements
plase	place
unerveral	universal
allong	along
instment	instruments
anuan	annum
intelectual*2	intellectual
soliders	soldiers
consistont	consistent
came	from
valintine	valentine
extraordnary	extraordinary
desteanaition	destination
avbel	available
anicty	anxiety
thinble	thimble
ofent	often
concounious	conscience
moen	moan
laste	last
succfull	successful
unfornatly	unfortunately
ackchely	actually
carfull	careful
skite	stick
efectuionally	affectionately
wrank	rank
fargrancy	flagrancy
permartely	permanently
specaman	specimen
bankrucpty	bankruptcy
rehersing	rehearsing
herd*4	heard
distingishes	distinguishes
regoen	region
ventilt	ventilated
commpitate	competent
ascape	escape
fullwards	forward
midia	media
coute	caught
apolgies	apologies
avanged	advantage
convenienty	conveniently
his	was
ghase	gauge
retane	retain
exfecinly	affectionately
head_mistress	headmistress
hapends	happened
attorneies	attorneys
fretunaly	fraternally
accompagnying	accompanying
contmun	countenance
invisable	invisible
relacks	relax
imeadittly	immediately
unfortunte	unfortunate
leasure	leisure
altometer	altimeter
weth_out	without
sianc	sank
weak's	week's
advertiseing	advertising
polleytishion	politician
moleculs	molecules
luved	loved
innorcent	innocent
trosh	touched
farest	forest
a_metlerl	immediately
pranmly	preliminary
dait	date
gams	gauge
sotck	searched
memerys	memories
payground	playground
tork	talked
releaf	belief
premanant	permanent
fryturnely	fraternally
tand	turned
beuteful	beautiful
wido	widow
baragining	bargaining
concensus	conscientious
sackitvansh	satisfaction
weat	wet
bait	date
tecmacke	technical
divident	dividend
mellonuse	melancholy
forturnitly	fortunately
enameyes	enemies
heavey	heavy
beastiality	bestiality
buletin	bulletin
solger	soldier
battels	bottles
communciate	communicate
whes	wishes
shap*2	shop
Juadism	Judaism
mame	made
eserdishon	exhibition
rerved	reserved
georgious	gorgeous
batfl	beautiful
cifarte	skilfully
undoutadly	undoubtedly
indefinet	indefinite
annimise	itemized
emmey	enemy
enthusasamin	enthusiasm
enisals	initials
gappet	galloped
alteturen	altitude
noticably	noticeably
atasher	altitude
its	his
tea_maker	tea-maker
soritety	sorority
rede	ready
theiths	thieves
ondoutally	undoubtedly
prosishon	precision
agressively	aggressively
unomise	unanimous
ocassionally*2	occasionally
agenies	agencies
La_Grippe	grippe
denyin	denying
ald	old
consiquently	consequently
linge	be
recquistion	requisition
curecosity	curiosity
valy	valley
fraternaily	fraternally
hrmehn	army
onen	own
senss	since
studing	studying
fre	free
lokel	local
pleace	please
garenteory	guaranteed
scary	scarcely
poltory	poetry
sitistic	statistics
pamflats	pamphlets
tobogurn	toboggan
conshenious	conscientious
stroy	destroy
proten	pretend
hiter	hit
rainfall	grateful
agriculturalist	agriculturist
voed	viewed
say	says
stummi	stomach
vallery	valley
damed	damaged
inconvenince	inconvenienced
refreshment	refreshment
advantageos	advantageous
cote	coat
econmace	economics
sincer	sincere
sichnetur	signature
guarenty	guarantee
galorry	gallery
hugers	anxious
conceineous	conscientious
mistlery	mystery
sats_fan	satisfaction
bun	but
ocrtur	orchestra
readicules	ridiculous
excargarate	exaggerate
waste	waist
appetiat	appetite
herlo	hello
sopte	spot
ake	ache
disatisfied	dissatisfied
expanily	exceptionally
satelite*2	satellite
cilme	climb
reulting	resulting
defianert	definite
von	vagabond
consived	conceive
auxillary	auxiliary
anniversiory	anniversary
suffantly	sufficiently
guage	gauge
reel	real
joine	join
lao	blue
anivessery	anniversary
primnally	preliminary
div	dive
exessively	excessively
incendentaly	incidentally
listsings	listings
daioned	date
vaciencys	vacancies
pupedist	prejudice
sceuduel	scheduled
orginially	originally
guruantee	guarantee
celabrate	celebrate
finantionally	financially
recresistion	requisition
bennificial	beneficial
hoy	our
picquesque	picturesque
qurantee	guarantee
be	been
gape	grippe
cesed	ceased
corspondence	correspondence
corrisponding	corresponding
acompanying	accompanying
miscelanius	miscellaneous
team_games	team-games
seame	seem
definitaly	definitely
representitive	representative
contients	countenance
ancot	raincoat
techenal	technical
eneyt	any
volger	vulgar
saltraron	subterranean
interlectible	intellectual
exshly	exceptionally
annoiences	annoyance
asade	especially
poney	pony
ans	answer
caresll	carefully
melecolly	melancholy
diamon	diamond
memordies	memories
acknowledge	acknowledging
annome	annum
ospsteete	opposite
suffienc	sufficiently
refressmunt	refreshment
emfrusedmy	enthusiasm
recet	receipt
russina	Russian
were	whereby
scolend	stolen
preteneded	pretend
wont*3	won't
traffice	traffic
councellor	counsellor
stict	strict
orp	opened
serfece	surface
reducition	ridiculous
ediquit	adequate
memoreres	memories
hidretik	hydraulic
depted	debit
quardian	guardian
orceter	orchestra
suceful	successful
groing	growing
concithis	conscientious
tale_run	trial-run
juses	juice
meloncholie	melancholy
ganing	gaining
vale	valley
trad	trade
bell_ringing	bellringing
continance	countenance
hone	horn
being	been
fiezzing	freezing
rwite	write
ironicly	ironically
badies	babies
physcoligy	psychology
kutere	contented
spented	splendid
consheanice	conscientious
satisfation	satisfaction
everythink	everything
graudilly	gradually
chemsitry	chemistry
babe	baby
reacently	recently
phone*3	phoned
comalbe	comfortable
af	earth
infonit	infinite
returnale	fraternally
ambuemce	ambulance
evengualy	eventually
johns	John's
contioance	countenance
maturially	materially
anzity	anxiety
liquify*3	liquefy
tornk_suint	tracksuit
agentic	agencies
sindaing	shaggy
frieted	frightened
ocustommed	accustomed
exagerrated	exaggerated
reffring	referring
satery	certainly
prosedger	procedure
consive	conceive
contemptable	competent
refridgator	refrigerator
pinacul	pinnacle
crier	prior
infenident	infinite
scand	scandal
tormenment	tournament
antisepating	anticipating
be_hin	behind
pinecal	pinnacle
I	and
assighnments	assignments
polution*2	pollution
demges	damaged
riged	rigid
totting	trotting
symophatic	sympathetic
arad	around
provission	provision
reparis	repairs
tanker	tankard
accustumed	accustomed
fundlementle	fundamental
famillior	familiar
searchde	searched
brouther	brother
Philipines	Philippines
howrse	horse
toched	touched
rembemer	remember
ded	dead
niet	night
spelled	splendid
teramant	tournament
excibation	exhibition
cantaloube	cantaloupe
remenbrance	remembrance
curtins	curtains
finattioncely	financially
safe*2	save
origonly	originally
temorary	temporary
systicts	statistics
registery	registry
he	the
intelengle	intellectual
suffiency	sufficiently
reckemandation	recommendation
curtisy	courtesy
reccomendent	recommended
out	not
carm	calm
reckcresition	requisition
animl	animals
restraunt*2	restaurant
archeaologists	archaeologists
spere	spare
conformation	confirmation
larhed	loud
espeshily	especially
quoriocity	curiosity
qucker	quicker
colloquilism	colloquialism
annonyance	annoyance
choeden	children
a_vod	avoid
desin	designed
anoyance	annoyance
reses	recently
faccinating	fascinating
knew	new
prefixt	prefixed
ete	eat
atterinies	attorneys
buisit	biscuits
virtuies	virtues
defennently	definitely
jugement	judgement
unexpickted	unexpected
faner	form
catal	castle
fasicinateing	fascinating
wos*5	was
averna	avoid
news_paper	newspaper
gallod	galloped
gond	again
temmper	temperature
paintaking	painstaking
desinded	designed
ligths	lights
abmeteb	admitted
enthuisiasm	enthusiasm
rumantisan	rheumatism
exitey	anxiety
ecomonic	economic
ocashanally	occasionally
probalem	problem
triumphet	triumph
unexspected	unexpected
sackryligus	sacrilegious
infinnent	infinite
releived	relieved
minninum	minimum
jewelery	jewelry
headmaster	headmaster's
kutiset	courteous
spcruf	spacecraft
four	fourth
miniscule*2	minuscule
trolly	trolley
semh	schemes
shuve	shove
vacancy's	vacancies
strenght*2	strength
anxous	anxious
brookes	brooks
picturesct	picturesque
afidaved	affidavit
propect	prospect
minetes	minutes
rauf	rough
desigen	destination
intoslate	intellectual
ecqunomic	economic
obersit	opposite
galyer	gallery
losed	lost
sirfishint	sufficient
polir	problem
caps*2	cops
vertually	virtually
hat	heard
minuminum	minimum
loned	loud
magnifecient	magnificent
accustommed	accustomed
plarnted	planted
entrese	entrance
Slaughthouse	Slaughterhouse
gardeian	guardian
technecil	technical
penumonia	pneumonia
oppretunities	opportunities
egzagerate	exaggerate
fascicaneting	fascinating
contente	contented
certinly	certainly
adoqate	adequate
exnomic	economic
viculay	facilities
bowt	belt
ordoniary	ordinarily
apostle	epistle
ememey	enemy
unconscience	unconscious
lifd	lived
breve	breathe
terdal	terrible
sleplus	surplus
strnad	strand
defanetely	definitely
shor	shore
anathm	annum
commuacate	communicate
shasan	satisfaction
dentilated	ventilated
rien	fire
volum	volume
Philosophy	philosophy
avalibale	available
recodnition	recognition
predjudic	prejudice
refereence	reference
spects	expects
coradioral	collateral
perpectual	perpetual
inthuseaasmn	enthusiasm
critying	circling
anum	annum
haen	that
uam	jam
antispate	anticipate
ivoid	avoid
some_on	someone
eccomic	economic
especialy	especially
brij	bridge
expsoch	exhibition
compartivly	comparatively
takin	taken
atacing	attaching
sicifaris	satisfaction
stastione	station
meen	mean
swterble	suitable
presdent's	president's
priviledges	privileges
douc	doubt
two*4	too
emploiees	employees
schuled	scheduled
accagionaly	occasionally
requsted	requested
tennisplayer	tennis_player
triveal	trivial
gareley	gallery
add	had
undoutetly	undoubtedly
apohlyage	apology
wit	went
stap	step
mant	want
det	date
poettry	poetry
feaver	fever
worred*2	worried
warck	work
misealinous	miscellaneous
enthusastik	enthusiastic
criticizasm	criticism
questionnare	questionnaire
divide	divine
grwo	grow
fenid	friend
kiffe	knife
tink*2	think
conserned	concerned
pecuilar	peculiar
propnent	continent
pogl	beg
sypthmetic	sympathetic
barler	beautiful
schol	schools
beter*2	better
curtesies	courtesies
necarssarly	necessarily
affectually	affectionately
cycoligy	psychology
exadgerat	exaggerate
rwit	removed
we	me
elegtrer	helicopter
coaperate	cooperate
mathmatician	mathematician
ecxadurate	exaggerate
acceptence	acceptance
dear	dare
palving	playing
conceal	counsel
apubed	absurd
decompositing	decomposing
tkaing	taking
exsistion	existence
faulse	false
meautalle	mutual
an*2	a
eperats	apparatus
nfre	after
skilly	skilfully
ilogical	illogical
furly	familiar
hunemoon	honeymoon
rectquisition	requisition
statictics	statistics
curni	colonel
sandal	scandal
heght	hedge
myestery	mystery
desidily	decidedly
exatuate	exaggerate
come*2	came
surcing	circling
head_misstress	headmistress
unsf	unsafe
epistile	epistle
bad*2	dad
eneatation	initiation
preticular	particular
curly_headed	curly-headed
diening	dining
dilapadated	dilapidated
acttive	active
famficay	financially
unamuse	unanimous
scissor	scissors
finacially	financially
dems	diamond
storise	stories
serntlny	certainly
acostumed	accustomed
vurlus	virtues
botom	bottom
saught	saucer
represinetives	representatives
euetr	equally
unaminus	unanimous
Kindergarten	kindergarten
senority	sorority
runaway	runway
setitfared	satisfaction
negatations	negotiations
adjorned	adjourned
vacancity	vacancy
divied	debit
curtente	contented
dormintory	dormitory
sister*2	sisters
contete	contented
their*16	there
potaos	potatoes
inconvenents	inconvenience
ahppen	happen
prestigeous	prestigious
exzity	anxiety
imthosemam	enthusiasm
rerreshment	refreshment
spead	speed
episil	epistle
missolainies	miscellaneous
consident	consonant
theri	their
bankrupsay	bankruptcy
approxamate	approximate
polie	peculiar
gurantee	guarantee
perqul	peculiar
linp	limp
matieral	material
contrevy	controversy
beneeth	beneath
opon*2	opened
imetialty	immediately
polictian	politician
pifishan	physician
benef	beneath
bulitons-	bulletin
tryadry	tragedy
stirrin	stirring
prejduice	prejudice
wocer	walked
lens	led
shock	shook
sizable	sizeable
pinickal	pinnacle
eliminatary	elementary
varyed	buried
sick	sink
merrors	memories
scudule	scheduled
safishently	sufficiently
biscui	biscuits
haws	house
exterordinary	extraordinary
biscan	bicycle
nossing	noisy
govormental	governmental
splendourd	splendid
voet	vote
miscelanuos	miscellaneous
deffinatelly	definitely
stasticties	statistics
lescher	leisure
outsid	outside
politicains	politician
perceved	perceive
docquments	documents
dinnings	dining
promblem	problem
vairi	various
themself	themselves
immedially	immediately
oridgenally	originally
lescive	leisure
czar	cancelled
suppart	support
namly	namely
accordense	accordance
tunage	tonnage
permaiently	permanently
buitful	beautiful
wern't	weren't
hydrolec	hydraulic
excution	execution
dede	bed
prisedents	president's
toed	toad
resause	resource
generrater	generator
affectionatly	affectionately
meirshin	machine
pistol	epistle
ruasturant	restaurant
courson	cousin
gradgle	gradually
soord	sword
vaires	various
wern	when
asthemed	esteemed
incedious	insidious
samer	seem
agsis	exists
aswering	answering
permmully	permanently
drek	dart
intergrated	integrated
ciets	city
Chatwakwa	Chautauqua
eventuely	eventually
ordarnarily	ordinarily
injons	enjoy
deliciant	delinquent
piolet	pilot
sied	side
vulger	vulgar
seceed	secede
garlle	gallery
decendant	descendant
wellvented	ventilated
mimium	minimum
scruf	scruff
prosedgor	procedure
ecommonics	economics
schedules	scheduled
trouble_maker	trouble-maker
acknowlegement	acknowledgement
coutioues	courtesies
falaly	folly
veresly	various
abuov	above
propely	properly
wolling	walking
attacheing	attaching
moths	noisy
costome	costume
woulded	wanted
prilimanary	preliminary
comparitolvily	comparatively
alonalp	helicopter
amnible	amiable
memberanon	memorandum
in_sis	inside
misalenus	miscellaneous
inexsusable	inaccessible
statsiefacsed	satisfaction
anthuisum	enthusiasm
imeditery	immediately
veseted	visited
incovenienced	inconvenienced
con	corn
rote	wrote
biscut	biscuit
preterded	pretend
abilty	ability
craker	cracker
abarater	operator
finanialy	financially
finaly	final
daing	doing
inconveneated	inconvenient
firh	fire
approxmatly	approximately
retalitated	retaliated
revew	review
chanch	chance
whimp	wimp
pelm	plan
specfically	specifically
intitiation	initiation
slipery	slippery
feme	form
espasially	especially
tine	tiny
tististicts	statistics
specifacully	specifically
negiatations	negotiations
predijist	prejudice
politicion	politician
redicalus	ridiculous
decidently	decidedly
referal	referral
misscelanious	miscellaneous
presidence's	president's
idesa	ides
pamphletts	pamphlets
canacellation	cancellation
cansellation	cancellation
defenet	definite
aranged	arranged
preferrable	preferable
stumace	stomach
wnated	wanted
mor	more
evay	every
set	sight
butlek	beautiful
folow	follow
ancrer	answer
schandel	scandal
particularly	particular
kentigarten	kindergarten
unpareled	unparalleled
spair_garr	spacecraft
descision*2	decision
courrious	curious
privielage	privilege
veis	various
skillverly	skilfully
preform	perform
rumaticism	rheumatism
agreable	agreeable
Rhumatism	rheumatism
lieable	liable
pursecorc	position
temporarlly	temporarily
aproved	approval
reckamendation	recommendation
jsut	just
wathout	without
umpart	alpine
dea	dodged
aturney	attorney
philoficy	philosophy
mary	marry
tiome	time
bankrupuy	bankruptcy
addres	adders
hid	height
peap	peep
mangnicet	magnificent
percula	peculiar
spring	springs
acquance	acquaintance
faiyhfully	faithfully
undestand	understand
compeled	compelled
climatoligists	climatologists
couldent	couldn't
wont	wont
diane	dining
ef	ever
ackward*2	awkward
cosumerly	customary
chariman	chairman
rummer	rumour
suman	solemn
dilverd	delivered
rearlers	surplus
wash	watch
coeece	coerce
practiaal	practical
acroved	accrued
incovenentist	inconvenienced
drow	draw
mimimium	minimum
stab	start
statithics	statistics
crat	great
apendix	appendix
adicquate	adequate
charachters	characters
peaple	people
magnefesed	magnificent
dispair*3	despair
coontry	country
dinner_times	dinnertimes
deliver	delivered
scambld	scrambled
debarcher	departure
connveniently	conveniently
specil	special
persue*3	pursue
Feburary	February
arrangments	arrangements
chrimbl	scrambled
suphisticated	sophisticated
wood_work	woodwork
slip	sleep
spad	spade
daner	done
best	belief
mysterie	mystery
conceved	conceive
difrans	difference
couth	caught
amberlance	ambulance
pefect	splendid
sod	sound
famer	farmer
bear*2	bare
reccommendations	recommendations
hit	height
pavment	pavement
ordinarilily	ordinarily
reckomend	recommended
side_car	sidecar
arth	loud
psiolochology	psychology
canselling	cancelling
ambivilant	ambivalent
minnium	minimum
rurel	rural
three	tree
brad	braid
cat	cut
affets	affects
hor	who
sec	cease
innition	initiation
temperrarially	temporarily
spic	special
concientious	conscientious
privalogy	privilege
efficiently	efficiency
suffiecentlly	sufficiently
concuous	conscientious
anxiciety	anxiety
matariel	material
crimamel	criminal
latets	latest
inslye	industry
we'el	we'll
achi	achieve
diah	dinner
phenumia	pneumonia
play_grond	playground
hypocracy	hypocrisy
bieng	being
dordments	documents
effecintcy	efficiency
conteous	conscious
concile	counsel
curtings	curtains
determain	determined
inkurnet	inconvenient
Ecomomical	economical
acorrdance	accordance
corsey	courses
plirimanary	preliminary
semphistic	sympathetic
last	one
Ile	I'll
deg	beg
specle	special
annen	any
shoan	sank
caere	community
anayles	analysis
commitive	committed
stare*2	stars
baner	banner
sade	sound
virteau	virtue
stumac	stomach
wtih	with
accknowledgement	acknowledgement
annivesrey	anniversary
incredibally	incredibly
autoruim	auditorium
hanee	any
goes	juice
Rango	Ranger
Europian	European
equitly	equally
boots	beautiful
presense*2	presence
wie	thin
critisise	criticize
flud	flood
fnaniancly	financially
hared	hard
peciular	peculiar
delt	dealt
tradedys	tragedy
mescelaneous	miscellaneous
pleasent	pleasant
nact	neck
refrigiter	refrigerator
beind	behind
dipartiar	departure
sherk	searched
ocuntries	countries
finanically	financially
venemous	venomous
condions	conditions
annamum	annum
aeriels	aerials
attoram	auditorium
pattarns	patterns
wod	wood
fanes	freezing
sear	scare
properganda	propaganda
docters	doctors
innessheation	initiation
contience	conscious
exisists	exists
felothocy	philosophy
unimployed	unemployed
principals	principles
vacinsas	vacancies
funmental	fundamental
going	coming
bene	been
narno	narrow
unusly	unusually
stumarc	stomach
discritation	discretion
doge	dodge
gragully	gradually
cougt	caught
deid	died
mite*2	might
enthing	anything
inysules	initials
buellitin	bulletin
loeg	lodge
antisipate	anticipate
bankruppect	bankruptcy
traffik	traffic
carit	curtains
wiss	wishes
adabtable	adaptable
nuber	number
bad	bed
restarount	restaurant
his	he
fianlly	finally
popoll	purple
wain	were
groon	grown
sugest	suggest
intectical	intellectual
incidendently	incidentally
ame	any
herd	here
staratr	sure
intemised	itemized
useing*2	using
remeniscences	reminiscences
havein't	haven't
prejudis	prejudice
incdently	incidentally
symetery	symmetry
usually	unusually
scicology	psychology
spleded	splendid
learn	learned
lede	led
weeks'	week's
misdameanors	misdemeanours
demy	deny
cucomber	cucumber
hooge	huge
familly	familiar
chemcial	chemical
galopet	galloped
encryptiion	encryption
guaraunteed	guaranteed
teahers	teachers
cheeroh	cheerio
spesl	special
adisction	edition
reoporter	reporter
anytying	anything
seige*2	siege
silf	self
subisitions	substitutions
lord	lorry
shggy	shaggy
renewed	viewed
bcak	back
thifeves	thieves
exspeniture	expenditure
ettmiter	altimeter
eastablishing	establishing
achievment	achievement
gam	jam
effeiciency	efficiency
there*18	their
parsel	parcel
taboggan	toboggan
toutched	touched
custamor's	customer's
locol	local
interrests	interests
trail_ran	trial-run
host	horse
anoma	annum
vose	voice
befulaful	beautiful
fermilliar	familiar
immedictly	immediately
withold	withhold
opproxamatly	approximately
icomized	itemized
undoubtavely	undoubtedly
missoleanus	miscellaneous
catagoris	categories
satfacso	satisfaction
fligt	flight
reant	rent
glass	class
curtain	curtains
down_stair	downstairs
on	off
seas	seals
eyery	every
acprocimatly	approximately
affectionly	affectionately
santel	certainly
alterchood	altitude
littl	little
helepier	helicopter
redicular	ridiculous
crepy	creepy
tims	times
house	horse
warn	worn
negociasions	negotiations
grut	great
dransfered	transferred
tail_run	trial-run
strived	strove
radify	ratify
spiritiaul	spiritual
o	oh
captian*2	captain
refregrator	refrigerator
anoiance	annoyance
misalentios	miscellaneous
werh	were
exevbichon	exhibition
aniversay	anniversary
col	call
carrentie	guarantee
dat	that
inacessable	inaccessible
acorll	actually
vouthur	voucher
presisian	precision
bennyfishaly	beneficial
commicate	communicate
rememberence	remembrance
ocassional	occasional
tem	team
comision	commission
recomnded	recommended
unformanlly	unfortunately
viricheu	virtue
creatitivity	creativity
toughed	touched
Chartors	Characters
cemtery	cemetery
leiusure	leisure
todays'	to-day's
analiss	analysis
promenent	prominent
lasy	lazy
wate*2	wait
suround*2	surround
reconitation	recognition
inconveience	inconvenienced
frosen	frozen
condiptions	conditions
restruarant	restaurant
coaght	caught
alumuna	alumni
end_less	endless
housholds	households
perfactly	perfectly
thourgh	thorough
phision	physician
anciticty	anxiety
pitet	pilot
notisbolle	noticeable
benifits*2	benefits
pregidise	prejudice
countenences	countenance
werth	worth
awfuly	awfully
verious	various
pome	poems
conchus	conscious
avible	available
cesh	sure
grater	greater
cavass	canvass
oridtionaly	originally
looge	lodge
sufficent*2	sufficient
Thems	Thames
magnificiante	magnificent
competed	competent
speshall	special
kino	know
baceball	baseball
permanenly	permanently
exzistance	existence
cookes	cookies
sa	should
bubbals	bubbles
verchues	virtues
if	he
sond	sound
shorch	sure
refriderator	refrigerator
surpose*2	suppose
belte	belt
redundent	redundant
cimertary	symmetry
fw	few
crucifiction*2	crucifixion
syas	says
daged	dodged
enyu	any
alsorts	all_sorts
angecy	agencies
magnefist	magnificent
loveable	lovable
eiroplane	aeroplane
privi	privilege
delquient	delinquent
benath	beneath
plerimalry	preliminary
allthough	although
satefasion	satisfaction
recieves	receipts
dieing*4	dying
extisy	ecstasy
evry_dody	everybody
exceptable	acceptable
some_thing*2	something
lone	lost
chaphter	chapter
bet	beat
fastenating	fascinating
oredr	order
bred	bread
andunaus	annum
re_gaind	regained
presidends	president's
sones	sons
ofr	of
knwo	know
contraversally	controversy
cocking	cooking
stoamac	stomach
gran	grain
varsus	various
graudully	gradually
schoo	school
discuse	discuss
contempory	contemporary
entheusiasism	enthusiasm
sak	sack
serplase	surplus
predjuice	prejudice
thhis	this
arneals	initials
foxx	fox
dispolvel	disposal
immedeitly	immediately
effert	effort
me	my
illiteraly	literally
negoatation	negotiations
put	but
eaghty	eighty
cilender	cylinder
saefe	surface
innitial	initials
flet	flight
prefere	prefer
surroded	surrounded
yersa	years
deing	beginning
imiedatly	immediately
biwes	best
partener	partner
figurs	figures
tom_boy	tomboy
sone*2	soon
acerle	actually
omiting	omitting
exaderate	exaggerate
sparcely	sparsely
inconveeneance	inconvenience
brock	break
ridiculuss	ridiculous
farly	fairly
economcil	economical
instrumants	instruments
long	wrong
selfs	selves
emergancy	emergency
erand	errand
illuminate	eliminate
economicial	economical
fraske_stinte	tracksuit
decededly	decidedly
her*2	heard
rabbit	rabbits
immippisal	epistle
colelatral	collateral
raped	rapid
melanchaly	melancholy
nonsence	nonsense
loundry	laundry
exectants	experience
whan't	wasn't
leed	led
drem*2	dream
telaphoned	telephoned
pritened	frightened
orcheaster	orchestra
funny	curiosity
corriculem	curriculum
rock	woke
bax	box
bicyclle	bicycle
adequite	adequate
sigantate	signature
annilable	amiable
faise	phase
dissypoint	disappoint
immeadiately	immediately
forwards	forward
bullutin	bulletin
stiticts	statistics
botton*2	bottom
tkaes	takes
psycological	psychological
prinicpales	principles
inteference	interference
Epissol	epistle
specsie	special
depercher	departure
enthuiasm	enthusiasm
Chtacu	Chautauqua
aburd	absurd
vane	vain
faiths	phase
gaurdain	guardian
monkay	monkey
enfants	infants
erge	urge
made	maid
shorariety	sorority
mystury	mystery
disenstion	destination
coladaro	collateral
instumants	instruments
rob	rub
coused	courses
ap	approaching
enormas	enormous
sonday	sunday
convential*2	conventional
flamboueant	flamboyant
flor*2	floor
aproverl	approval
spelloll	special
teld	told
altimiter	altimeter
fourty*2	forty
fowm	form
turne	turn
ordaniarly	ordinarily
predgejust	prejudice
dongle	dangle
predominently	predominantly
fixt	fixed
organisatios	organizations
medicin	medicine
questionier	questionnaire
cunnidge	tonnage
coninuous	continuous
million_air	millionaire
what_ever*2	whatever
inticipate	anticipate
maturally	materially
dilived	delivered
freturnially	fraternally
compeating	competing
turimant	tournament
erspendituer	expenditure
suplimente	supplement
courties	courtesies
largh	laugh
signture	signature
blok	block
oposite*2	opposite
wonk	woke
affectionote	affectionate
refrigertor	refrigerator
susici	suspicion
biy	by
voutere	voucher
sidn*5	said
glars	glass
owe	our
post	posts
requission	requisition
efford	effort
belive*2	believe
shok	shock
economico	economical
convemation	confirmation
cleark	clerk
gatr	gate
dat	date
amittenly	immediately
undastand	understand
valey	valley
spectatoes	spectators
converlesance	convalescence
acording	accrued
oar	are
Ysid	Yard
firend	field
gust*5	just
laghfe	laugh
comen	community
minemom	minimum
dispoint	disappoint
dige	dig
enalicis	analysis
auditorial	auditorium
seer	saw
coraspondance	correspondence
everone	everyone
pelimanary	preliminary
recquisem	requisition
recuazition	requisition
instrments	instruments
strainous	strenuous
onel	answer
pteire	particular
conditining	conditioning
finachel	financial
apparentlly	apparently
cancilliation	cancellation
happyness	happiness
scientic	scientific
kindegarten	kindergarten
tkae	take
bueiful	beautiful
Wesh	Welsh
nessary	necessarily
exstaplishing	establishing
magnivisont	magnificent
aright	alright
and	one
couriosoty	curiosity
eit	eye
almeadly	immediately
ferture	virtue
episule	epistle
proplom	problem
garrete	guarantee
spects	aspects
watter	water
secondery	secondary
sarrority	sorority
mutten	mustn't
acknowlging	acknowledging
skillful	skilfully
ingered	injured
foreever	forever
wheh	when
kindergardent	kindergarten
move	moving
antiapating	anticipating
distirshed	distinguished
fridend	frightened
faud	found
cansel	cancelled
denigy	deny
paliamentarian	parliamentarian
atturney-	attorneys
perminently	permanently
good	opened
fit	fight
treneous	strenuous
wart	wrote
rought	roughly
finatul	financial
logde	lodge
vant	van
tepy	type
busciuts	biscuits
serfishe	surplus
technecal	technical
knoledge	knowledge
aurgument	arguments
cargt	caught
embaraced	embarrassed
arinlan	aeroplane
for_way	forward
wite	with
fluorishes	flourishes
statistic	statistics
intellegence	intelligence
memum	minimum
rporigs	repairs
sacked	searched
villige	village
enitiation	initiation
wicken	weaken
mettreay	materially
aufully	awfully
missiour	monsieur
theif*2	thief
trein	train
predujice	prejudice
forces	force
loued	loud
pollyties	politician
tragedidy	tragedy
sempathetic	sympathetic
Shitaka	Chautauqua
spelended	splendid
current	curtain
recgising	requesting
incidentily	incidentally
affidevit	affidavit
finicially	financially
oridnigly	originally
guadean	guardian
represantives	representatives
bouyant*2	buoyant
exoskelaton	exoskeleton
othere	other
equinomical	economical
wefe	with
acentces	agencies
serted	started
nothern	northern
straghted	started
thourely	thoroughly
plomeber	problem
counventens	competent
appareantly	apparently
ecomnical	economical
suffecienty	sufficiently
bircyls	bicycle
fulgur	vulgar
rologer	vulgar
guarentees	guarantees
gasaline	gasoline
sounet	sound
hans	hands
localy	locally
sivise	surface
Comgress	congress
vargaboard	vagabond
stopen	stolen
intellcial	intellectual
betuiful	beautiful
iperens	experience
resonable	reasonable
ovord	avoid
picture	picturesque
notife	notify
pschology	psychology
mist*3	missed
matiriale	materially
bruch	brush
refirred	referred
tarin	training
ganed	gained
persausion	persuasion
unfotunalty	unfortunately
refiguater	refrigerator
cunnage	tonnage
adjurnment	adjournment
take	turned
phiolosphy	philosophy
aierre	ere
apparatous	apparatus
approxinate	approximate
emencelly	immensely
stokings	stockings
coures	courses
opra	opera
nessasairly	necessarily
matathmatics	mathematics
btade	pretend
scercly	scarcely
announce	annoyance
precedent's	president's
eseserlly	especially
controveries	controversies
ded	deed
immence	immense
couse	coarse
sow	sows
predgious	prejudice
undforgetall	unforgettable
simertry	symmetry
heirarchy	hierarchy
peotry*2	poetry
philslopy	philosophy
intutively	intuitively
work	woke
vacantance	vacancies
defanate	definite
drye	dry
wint	very
cigaret	cigarette
jobcenait	jobcentre
infosastic	enthusiastic
drammatic	dramatic
memmorys	memories
convalessance	convalescence
aringeds	apparatus
holl	hall
rediclious	ridiculous
departed	departure
corosion	corrosion
flagerancy	flagrancy
aloud	allowed
frender	friends
apuval	approval
ovygex	oxygen
Will	While
meteraily	materially
redickles	ridiculous
affictiratly	affectionately
ecpecially	especially
thoughty	thoroughly
representiveties	representatives
collatertrat	collateral
predudous	prejudice
vesle	recently
delinquenut	delinquent
dificult	difficult
reconnd	reckon
techet	teachers
snab	shaggy
desision	decision
deturmaned	determined
notisbool	noticeable
modal*2	model
protented	pretend
curiostey	curiosity
malloncolly	melancholy
droped	dropped
wied	women
ratding	rating
equlk	equally
polytishion	politician
mu	mist
womow	women
wat	loud
infusieasom	enthusiasm
appoligy	apology
gatr	great
guerrilas	guerrillas
houshe	household
olso	also
remend	remember
sceduled	scheduled
literually	literally
Delagates	delegates
unfortent	unfortunate
geenus	genius
had	wanted
and	he
sertinly	certainly
dogged	dodged
transferr	transferred
safit	surface
virteous	virtues
aparot	apparent
peaper	people
accompying	accompanying
showt	shout
holesale	wholesale
apriciate	appreciate
ordenary	ordinary
srowened	surrounded
noses	noisy
morgags	mortgage
indifinate	indefinite
inconvinced	inconvenienced
extreamly	extremely
finanshel	financial
saught	sought
satifielty	satisfactorily
pre-historic	prehistoric
confermation	confirmation
visitid	visited
consenience	conscientious
fihet	fight
ofomt	from
tempricher	temperature
rablenackle	technical
phsicology	psychology
concienanse	conscientious
lateest	latest
and	accident
prophesy	prophecy
artifically	artificially
organ	again
home_work	homework
seduled	scheduled
regernent	region
redeculous	ridiculous
magg	beg
horn_rimed	horn-rimmed
permennam	permanent
congralulations	congratulations
consonent	consonant
domfordion	comfortable
melancholly	melancholy
contentie	contented
speciments	specimens
bradcast	broadcast
ophoned	orphaned
excell	excel
gartee	guarantee
recetey	recently
equesting	requesting
semitry	cemetery
negoceations	negotiations
foned	food
vagbond	vagabond
speacking	speaking
Autin	Austin
deabite	debit
sherfishent	sufficient
doubte	doubt
anumny	alumni
became	be_coming
curent	current
communitate	communicate
phacificially	specifically
olny	only
axerdent	accident
fie	folly
exarrate	exaggerate
nessesity	necessity
frindes	friends
tehy	they
supercede*3	supersede
espeslet	especially
anoints	annoyance
semi	schemes
epistol	epistle
receipt's	receipts
exsepshionly	exceptionally
fassion	fashion
kepper	keeper
curtiscy	courtesies
rea	researchers
suterble	suitable
doar	door
rumitisum	rheumatism
exterce	ecstasy
opportunitys	opportunities
wening	women
dael	dahl
certian	curtain
preduis	prejudice
cometent	competent
damaged	damage
ld	I
dirven	driven
pssess	possess
expinture	expenditure
rhomentic	romantic
awer	answer
presadent's	president's
eate	here
grate	great
amaiable	amiable
pupil	purple
ggot	great
aneversory	anniversary
token	taken
continos	continuous
hedmaster	headmaster
tenber	timber
cafic	traffic
noine	noisy
unfortunat	unfortunate
erasistoble	irresistible
difues	defuse
balhot	belief
proply	properly
event_bold	everybody
refreduator	refrigerator
reccominding	recommending
perllips	Philip's
soroarate	sorority
exsis	exists
compeltion	completion
mongerge	mortgage
mainenance	maintenance
customory	customary
occaisionally	occasionally
auditormeon	auditorium
tourmad	tournament
sucipition	suspicion
artillary	artillery
missalaes	miscellaneous
bycicyle	bicycle
indeffinitly	indefinitely
arachester	orchestra
harsten	harassed
ellomontry	elementary
redikulis	ridiculous
passed	past
custamery	customary
does'nt	doesn't
sgasly	scarcely
pretiest	prettiest
hant	plan
especily	especially
gowe	go
addres	address
fircin	freezing
dessipoint	disappoint
apperats	apparatus
la-by*2	layby
indeafant	indefinite
galmedt	galloped
kindly	kind
abrusimate	approximate
assertaine	ascertain
aboyed	avoid
bufer	beautiful
play*2	playing
tobboan	toboggan
primey	primary
capaserty	capacity
shefint	sufficient
potet	pockets
lessons	lesson
fulfillment	fulfilment
correcte	correct
bourd	bored
larvd	laughed
texates	technical
voise	voice
come	comb
archetects	architects
exhileration	exhilaration
bode	body
distigushed	distinguished
rought	rough
faviote	favourite
oportumities	opportunities
positon	position
sank	sound
atlesould	altitude
affactionate	affectionate
phamph	pamphlet
enterns	entrance
spase	space
sugest	subject
wisting	whistling
lact	back
temperter	temperature
stomact	stomach
exest	exists
ealoy	enjoy
rain_cote	raincoat
mishing	machine
tam	tame
juies	juice
silfle	skilfully
fina	financial
condem	condemn
soe	so
inhesles	initials
intejilent	intelligent
brakke	brake
rased	raised
satifactory	satisfactory
lie	live
thror	they
takle	tackle
heolop	helicopter
grautually	gradually
aroed	avoid
bicuites	biscuits
renue	renew
danerer	dangerous
bav	?
abserb	absurd
cearton	curtain
excatly	exactly
rect	rec
unaminuous	unanimous
ingage	engage
ridiculois	ridiculous
cantenti	contented
exeplishing	exceptionally
out	own
isotrop	isotope
appaled	appalled
madniest	magnificent
askin	asking
especailly	especially
porble	problem
affectsolutely	affectionately
properlon	problem
exterordenary	extraordinary
annoieance	annoyance
lourd	loud
catagorey	category
knell	knife
oftent	often
infenate	infinite
enquisit	exquisite
sacisfacsh	satisfaction
sciverly	skilfully
approxinatly	approximately
a_wean	away
philosephy	philosophy
adolecent	adolescent
geometriy	geometry
vertrue	virtues
jiunor	junior
alumini	alumni
macfvicent	magnificent
refressment	refreshment
resit	receipt
supervison	supervision
ackseptable	acceptable
virde	vivid
appartenately	apparently
re_mind	remind
facilty	faculty
enacesiable	inaccessible
hinderance	hindrance
benghts	beneath
magnisphant	magnificent
reprotation	reputation
smimi-skilled	semi-skilled
gessed	guessed
vacantces	vacancies
possitive	positive
thoroughally	thoroughly
garentee-ed	guaranteed
wed	weed
mafnificent	magnificent
conscenceous	conscientious
mountonous	mountainous
choice	chose
trend	turned
sheepe	sheep
fined	friend
rumitisumn	rheumatism
cernol	colonel
gardeane	guardian
happen*2	happened
emmigrated	emigrated
was_fill	whistling
roud	rude
bultlyfull	beautiful
unblale	unparalleled
sutible	suitable
redey	ready
vundimental	fundamental
dinon	diamond
prim	primary
alimentory	elementary
bearraid	buried
payed*3	paid
ashame	ashamed
pes	peas
mustine	mustn't
medical	medical
satasfactorly	satisfactorily
unusualy	unusually
unoiense	annoyance
situating	situation
permamently	permanently
mimimum	minimum
emencally	immensely
appietite	appetite
thes	this
violonce	violence
in	impractical
inconivnence	inconvenience
sugested	suggested
somock	stomach
copywrite	copyright
compet	completing
insedetely	incidentally
leanr	learn
millionnaire	millionaire
disabelled	disabled
inconvienienced	inconvenienced
musintent	mustn't
pirtral	spiritual
meney	many
agenceys	agencies
opesit	opposite
felosope	philosophy
cancely	cancelling
uggested	suggested
cofens	coffins
overe	over
numbe	number
mistry	mystery
phraise	phase
yesars	years
magenivisened	magnificent
enigne	engine
remantic	romantic
pictureask	picturesque
contempe	contented
desacidy	decidedly
serpulse	surplus
courtss	courtesies
talk	talked
sicogoly	psychology
wiman	women
morgige	mortgage
schedul	schedule
lost	last
montor	monitor
perculiar	peculiar
abound	about
critisize*2	criticize
suceed*2	succeed
als	as
immencially	immensely
splenden	splendid
embarresed	embarrassed
consal	counsel
beleived*2	believed
enbarrased	embarrassed
imaganation	imagination
lite	lights
scaresley	scarcely
poliet	pilot
graphicaly	graphically
sussecful	successful
haed	head
scandle	scandal
saing	sank
unimas	unanimous
plansted	planted
prlular	peculiar
sager	shaggy
affadavat	affidavit
sasticics	statistics
assasinations	assassinations
recqest	requesting
Nazereth	Nazareth
controvercey	controversy
wass*2	was
annalasias	analysis
remder	remember
curtious	courteous
establaision	establishing
rarver	rather
bootf	beautiful
juis	juice
exturorary	extraordinary
georgous	gorgeous
enforeastic	enthusiastic
espesaly	especially
sicolagee	psychology
beleive*3	believe
rain_cout	raincoat
adquante	adequate
presure	pressure
alote	a_lot
eqauly	equally
cansulling	cancelling
indisputible	indisputable
louer	lower
nicociation	negotiations
sotyr	story
bineing	dining
companys*2	companies
awserw	answer
inury	injury
kerten	curtain
fayes	phase
merguge	mortgage
outameter	altimeter
critizom	criticism
extered	exerted
tourch	torch
costumer	customer
aimeualable	amiable
refrigrater	refrigerator
butifel	beautiful
deim	deem
insient	innocent
dinasour	dinosaur
maknivison	magnificent
permannetly	permanently
coms	comes
misilanious	miscellaneous
get	great
sall	shall
infromation	information
acrud	accrued
inniciation	initiation
a_with	away
pla	plan
worse	worst
boomaranges	boomerangs
technecally	technically
ganges	gangs
jump*3	jumped
lould	loud
exsenive	extensive
annaversiry	anniversary
falk	fork
tyhat	that
affectinatly	affectionately
procesor	processor
entiligual	intellectual
ajurin	adjourned
onfortumatly	unfortunately
slite	slight
drought	dropped
lovey	lovely
estading	establishing
glourious	glorious
baskek	basket
ther*7	there
recomending*2	recommending
not	nut
spliend	splendid
miscalanious	miscellaneous
ad	had
disaned	designed
prentend	pretend
aftere	after
prasp	perhaps
sheat*2	sheet
sier	stars
sede	seed
finically	financially
splet	splendid
bush	brush
prefferred	preferred
recamendations	recommendations
ack	ask
urbote	about
cam	cup
parth_way	pathway
radicing	rating
wheather	whether
hadr	heard
critisum	criticism
disgration	discretion
fren	friend
benifficial	beneficial
taek	take
reconon	reckon
flay	fly
missterious	mysterious
prevaded	pervaded
bon	bone
blak	black
becane	beginning
corriders	corridors
besau	pretend
alumentry	elementary
sew	saw
outfet	outfit
comparetivily	comparatively
guaranttee	guarantee
committee	committed
aticipation	anticipation
tallk	talk
accomodating	accommodating
perifery	periphery
speciefic	specific
abunt	about
brihifull	beautiful
bel	stomach
spen	spin
abe	been
feod	found
ill	I'll
suffeciently	sufficiently
stoble	suitable
beteen	between
hast	?
uninbud	unemployed
comepitent	competent
elementry	elementary
garunteed	guarantee
thourah	thorough
rait	rate
claim	climb
negoodations	negotiations
equely	equally
seariously	seriously
mane*2	main
tank	turned
critisym	criticism
incrsin	increasing
parrakeets	parakeets
irisable	irresistible
poerty	poetry
rouef	rough
houres	horse
beutifully	beautiful
congraduations	congratulations
beneth	beneath
permenantly	permanently
flagancy	flagrancy
toring	trotting
trobel	trouble
ordiniarly	ordinarily
permenent	permanent
revue	review
welth	wealth
regeted	regretted
porertrey	poetry
ocasions	occasions
Stanlay	Stanley
memerable	memorable
approxiametely	approximately
speritual	spiritual
mystirious	mysterious
exhasted	exhausted
advainet	accident
sinck	sink
tobogone	toboggan
wop	chop
corrador	corridor
afatait	affidavit
pege	beg
regon	reckon
antecipation	anticipation
namin	minimum
recomandition	recommendations
emmision	emission
exculy	ecstasy
fimular	familiar
arrangemence	arrangements
imminsely	immensely
statistikes	statistics
kitchin*2	kitchen
famelear	familiar
eppisial	epistle
offense	offence
arrangement	arrangements
ster	spare
disenged	designed
opiste	opposite
priveliged*2	privileged
playes	plays
deadil	deadlier
scheuled	scheduled
powerfull*2	powerful
grafitti	graffiti
shaging	shaggy
episicle	epistle
opoond	opened
cace	case
rumetisum	rheumatism
ple	pleased
cept	kept
daring	dart
recqusistion	requisition
hoesh	house
atheletics	athletics
approcksament	approximate
sinning	spinning
reponse	response
aserdent	accident
infaint	infinite
necessarially	necessarily
singl	single
actcepuanlly	exceptionally
recommition	recognition
bellefull	beautiful
apologe	apology
grouned	ground
niose	noisy
sor	saucer
instipated	anticipate
paws	pause
comfartable	comfortable
effiency	efficiency
depudy	deputy
solt	ship
lucking	looking
solders	soldiers
dooged	dodged
reconece	reckon
expurtes	experience
intellegual	intellectual
plases	places
gingam	gingham
well_educated	well-educated
indepedantly	independently
marks	masks
memaradan	memorandum
propellor*2	propeller
appaulling	appalling
comperlis	convalescence
inployee	employees
tack*2	take
procedger*2	procedure
acse	anxious
deffinatly	definitely
semi-colon	semicolon
inressitable	irresistible
ching	choosing
affadapfed	affidavit
anoynas	annoyance
horres	horse
detrement	determined
furmiler	familiar
compair	compare
cercular	circular
apeptite	appetite
will	with
broady	broadly
dom	do
tumage	tonnage
preturiest	picturesque
receved	received
precidis	prejudice
dominatory	dormitory
time_tables	timetables
stem	steam
shet	sheet
sabboth	sabbath
kem	came
fortenlly	fraternally
manes	names
windey	windy
is	it's
wiskey*3	whiskey
tearcher	teacher's
vacaciencies	vacancies
Recommendations	recommendations
accrewed	accrued
portrer	poetry
hetephonen	telephoned
avd	avoid
sintenle	certainly
hellecopter	helicopter
ansrew	answer
jodceter	jobcentre
aflly	actually
gravey	gravy
cotage	cottage
shay	shaggy
will	well_as
gardein	guardian
accasional	occasional
aclimplised	accomplished
anticupate	anticipate
repersentatives	representatives
pinecall	pinnacle
pusing	pushing
unfournate	unfortunate
him	he
arived*2	arrived
chees	cheese
tobogn	toboggan
biscut	biscuits
od	order
is_seply	especially
clody	cloudy
regeard	regained
scholarstic	scholarly
innoncent	innocent
stranuses	strenuous
baby	babies
comartey	customary
temporarilly	temporary
mous	most
hinself	himself
ferid	friend
gaurd	gourd
coorperation	corporation
weten	when
whanted	wanted
ambision	ambition
achievments	achievements
techniquely	technically
got	goat
geomoratry	geometry
wich	what
coursety	courtesy
cap	cup
bereivement	bereavement
heltege	hedge
shedy	shaggy
mudr	mud
metet	metals
dommority	dormitory
alliviate	alleviate
contemti	contented
turn	turned
inaxssecible	inaccessible
betiful	beautiful
befrou	before
voulger	vulgar
intullictual	intellectual
excells	excels
purturely	fraternally
vacanze	vacancy
sprianed	sprained
vagbonley	vagabond
courteces	courtesies
occationaly	occasionally
happly*2	happily
sachen	satisfaction
proculiar	peculiar
enthusasm	enthusiasm
virtueous	virtues
conscienous	conscious
apoch	approaching
orginal	original
whorter	walked
chikens	chickens
consesptions	conception
scor	score
recantyly	recently
affadavite	affidavit
epislte	epistle
motuarley	materially
ston	stone
wonderous	wondrous
anniverscy	anniversary
wob	would
tradgu	tragedy
job_center	jobcentre
indefanate	indefinite
that	they
fest	feast
bicuths	biscuits
memmories	memories
borol	beautiful
won	won't
regrected	regretted
mernisegat	magnificent
fried	tied
stetistic	statistics
voultures	voucher
guarrenteed	guaranteed
mointinuss	mountainous
truley	truly
correspondences	correspondence
that	the
millitary	military
guarrentee	guaranteed
absorbant	absorbent
subtiranean	subterranean
primal	primary
girlfriend	girlfriends
intellagence	intelligence
abseved	absurd
consciou	conscience
adaquit	adequate
anniable	amiable
inishals	initials
beggin*2	begin
intantion	initiation
requetion	requisition
decidially	decidedly
ere	earth
inmedently	immediately
phpisian	physician
polaral	peculiar
phzestion	physician
peoms*2	poems
fellowed	followed
rereashment	refreshment
cerimonious	ceremonious
sat_fainand	satisfaction
misrable	miserable
garea	gallery
comparativaly	comparatively
provisionaly	provisionally
gallop	galloped
get*4	gets
expern	experts
vagonbond	vagabond
fare	fair
stomoak	stomach
warkd	walked
nortey	naughty
arbitary	arbitrary
redeciolous	ridiculous
strainuous	strenuous
muself	myself
will	when
estaplishing	establishing
tend	turned
bal	beg
aniverseray	anniversary
yas	yes
bankrupes	bankruptcy
mouterroes	mountainous
rengin	region
gerdually	gradually
condition	edition
polytechan	politician
annaum	annum
tine	thin
towl	towel
opersite	opposite
comuniate	communicate
ammidal	amiable
watting	waiting
abraters	apparatus
telehponed	telephoned
alfory	awful
Unfortunately	unfortunately
marvelous	marvellous
cloackrooms	cloakrooms
disincwised	distinguished
aportunates	opportunities
laugth	laugh
reciever*2	receiver
ellection	election
particlar	particular
arsor	answer
file	final
prooved	proved
condeson	conditions
intionals	initials
pooiste	opposite
misullanous	miscellaneous
sarshed	searched
puplel	purple
geomentry	geometry
suralty	sorority
anziaty	anxiety
congratulate	congratulations
faies	phase
rson	answer
fok	folk
arpertunities	opportunities
intrentence	entrance
immeadily	immediately
rocords	records
gread	grade
unfor	unforgettable
inneciation	initiation
hait	height
conceince	conscience
aprockamently	approximately
stummec	stomach
scassly	scarcely
serface	surface
one*2	won
minium	minimum
Contient	continent
convenient	conveniently
bautful	beautiful
concevee	conceive
corresondence	correspondence
sheertes	sheets
nuck	neck
panel	plan
seriouse	serious
ponds*2	pounds
thoroughily	thoroughly
continente	contented
roster	rooster
resarc	research
lenght*2	length
ganed	gate
gowed	glowed
criticisam	criticism
fis	final
sen	seen
satifatorally	satisfactorily
scandall	scandal
confimation	confirmation
swonge	swung
succesfel	successful
enviroments	environments
dormarty	dormitory
surntered	certain
riliu	really
inniseation	initiation
strengh	strength
tacksot	tracksuit
naw	new
reconmendation	recommendation
mnfs	magnificent
disnertion	destination
bankrucpy	bankruptcy
decideally	decidedly
sack	sake
corrspondence	correspondence
spreaded	spread
vacantises	vacancies
Shawtachwa	Chautauqua
basket-Ball	basketball
proff	proof
morgege	mortgage
phalosafy	philosophy
alumna	alumni
undoubtalady	undoubtedly
operators	apparatus
hrmehr	army
encreasing	increasing
memorys	memories
how	hoe
champian	champion
oppersist	opposite
basful	bashful
phyilosophey	philosophy
things	thing
gripe	grippe
ekwely	equally
dying	dining
explanotory	explanatory
sorrity	sorority
traph	traffic
ep	experimental
effeciency	efficiency
anwenser	answer
bal	ball
subterraean	subterranean
deling	dealing
wud	wonder
pirch	perch
highdrolick	hydraulic
divedend	dividend
emmensely	immensely
wilk	walking
consuntrate	concentrate
lod*4	old
movaless	marvellous
dispoulsal	disposal
cope	copy
inconvincence	inconvenience
fli	fly
matmatic	mathematics
temptige	temperature
secely	scarcely
we'll	will
remmbranse	remembrance
acquantants	acquaintance
assisstant	assistant
bueaty	beauty
gemeotry	geometry
fo*2	for
month*2	months
shage	shaggy
recression	requisition
scrambeld	scrambled
debth	depth
collarteral	collateral
thgat	that
addmitted	admitted
choirs	prior
inmotly	immediately
sexul	sexual
iliminate	eliminate
cilinder	cylinder
accomused	accustomed
loge	lodge
visied	visited
conisious	conscious
comunat	community
inclusiv	enthusiasm
dost	dust
occasonially	occasionally
tired*2	tied
minester	minister
dirwe	bridge
dirt	dart
recresting	requesting
lawd	loud
mkae	make
volounteer	volunteer
sufficantly	sufficiently
straines	strenuous
ascertained	ascertain
differant	different
inthusastec	enthusiastic
he	here
asiley	actually
tchers	teachers
eles	Ellis
dreamin	dreaming
commenties	committees
simpathectic	sympathetic
fitund	frightened
inaccesitble	inaccessible
anticapating	anticipating
treadgidous	prejudice
courtoueses	courtesies
fealing	feeling
prcessing	processing
piotels	pilot's
relasions	relations
apparentley	apparently
Economics	economics
sufficency	sufficiently
hardley	hardly
anshoss	anxious
enar	answer
eving	even
courtesey	courtesy
haurs	horse
groun	grown
hand	and
condidierns	conditions
aterning	attorney
eccomonics	economics
prtened	pretend
sycolage	psychology
eye*2	eyes
incouncent	innocent
auditiorm	auditorium
went	with
scadualy	schedule
memeroies	memories
andandn	accident
accomodiate	accommodate
satisfactorcly	satisfactorily
addict	adequate
enthuseasm	enthusiasm
savantly	sufficiently
condishants	conditions
bonkrucpty	bankruptcy
far	for
cematry	cemetery
dieing	dyeing
indinet	indefinite
oathe	other
turmanent	tournament
allienate	alienate
thees	these
aweser	answer
enegine	engine
patoes	potatoes
de	be
explane	exceptionally
wet*6	went
vaciouney	vacancies
preceased	perceive
oging	ogling
dor*2	door
ofrer	over
lessure	leisure
unanasmons	unanimous
confernation	confirmation
site	city
miserlaneish	miscellaneous
siat	sight
mestry	mystery
audiotorium	auditorium
desidely	decidedly
condse	conditions
calers	colours
auditorinum	auditorium
trijant	triumph
preafer	prefer
stoumak	stomach
approachmently	approximately
fare	fire
efficat	efficient
orkisty	orchestra
anomina	pneumonia
agency	agencies
veri	very
unyep	unemployed
furuther	further
truthfull	truthful
panlet	pamphlet
imence	immense
garrntee	guarantee
toght	touched
creept	crept
foaks	folk
mathamates	mathematics
rembered	remembered
Sylver	Sylvia
kintergarden	kindergarten
thorught	thought
corresponce	correspondence
tocting	trotting
tiem	Tim
recretion	requisition
spitrial	spiritual
decid	decidedly
garrent	guarantee
foar	form
expendehure	expenditure
reck	wreck
establesing	establishing
connel	colonel
scandual	schedule
inatitals	initials
valchor	voucher
chork	chalk
bicsnits	biscuits
tuff	tough
ordanaryily	ordinarily
run	are
canvous	canvass
reccomondation	recommendation
pla	pleasure
drafec	traffic
saing	spinning
oppesite	opposite
allowence	allowance
virtrue	virtue
techician	technician
thoy	thought
enetiation	initiation
urborth	above
enivenutualy	eventually
econmo	economics
arrive	arrived
hygeine*2	hygiene
a_seph	asleep
sots	stars
blead	bleed
fundimentle	fundamental
blue	blew
saus	saucer
adicivat	adequate
boot	belt
off_center	off-centre
p	breaking
chearful	cheerful
quarall	quarrel
scampeld	scrambled
fiton	frightened
aninum	annum
conterversy	controversy
skae	scarcely
bulten	bulletin
ferternaly	fraternally
askendent	accident
pocikeds	pockets
tempersh	temperature
sare	sure
remimed	remind
addjurned	adjourned
stranious	strenuous
immenant	immanent
ronud	round
moter	machine
go	do
transfer	transferred
babe	babies
yemorthd	removed
be_come	become
and	on
assrtain	ascertain
reaseet	receipt
nobudy	nobody
paficaly	specifically
som	so
prsioners	prisoners
genuss	genius
iw	eye
satisfactarily	satisfactorily
contraverse	controversy
panthlete	pamphlet
supressing	suppressing
stilus	stylus
vised	visited
gaige	gauge
annicalys	analysis
signiture	signature
curtion	curtain
yah	cup
quesionuse	questionnaire
exaiter	experts
refrechment	refreshment
mate	most
undoubtally	undoubtedly
pearent	parent
indiffenately	indefinitely
suterbell	suitable
seahed	searched
greatful*2	grateful
illegitmate	illegitimate
tile	till
spacifilly	specifically
scedugal	schedule
tell_tailing	telltaling
goopes	groups
vacentisy	vacancy
ansisity	anxiety
find_them	final
epoury	employer
incedental	incidentally
gordigous	gorgeous
enomices	economics
beuitifiel	beautiful
unser	answer
anaversity	anniversary
psyciology	psychology
firnashal	financial
speciel	special
halloe	hallo
assatain	ascertain
alltimeter	altimeter
selpliss	surplus
colarlial	collateral
anticapting	anticipating
mony	many
cancelatin	cancellation
frips	flips
suprise	surprised
take	taken
repremanded	reprimanded
analys	analysis
fasinatting	fascinating
spiecal	special
guic	juice
tradety	tragedy
hammerskjold	hammarskjold
inquir	inquire
centruy	century
contions	conditions
inconviencied	inconvenienced
desiddly	decidedly
gaet	great
opne	open
gargle	gallery
purminent	permanent
lafing	laughing
aroeplane	aeroplane
outermetre	altimeter
preduse	prejudice
undoubtetly	undoubtedly
miscellous	miscellaneous
fried	friend
callatural	collateral
visitd	visited
spellend	splendid
piticular	particular
thaw	there
satishan	satisfaction
picth	pinched
necessarialy	necessarily
autor	author
analices	analysis
symetrically	symmetrically
sophmore*2	sophomore
atashing	attaching
conciantious	conscientious
belive	belief
satifly	satisfy
custamisation	customization
assigmments	assignments
abreashed	appreciate
grops	groups
finall	final
consentrate*2	concentrate
sunley	southern
hosre	house
excep	exceptionally
celabration	celebration
dowe	down
frigtend	frightened
orbitting	orbiting
affedavid	affidavit
approsamate	approximate
goohet	seem
fascenating	fascinating
cristmas	Christmas
curiosities	curiosity
electon	election
temporaily	temporary
subturanium	subterranean
shovle	shovel
emecatly	immediately
despoulsal	disposal
minumend	minimum
continnent	continent
weary	wary
temparary	temporary
referred	preferred
humly	humbly
misslain	miscellaneous
estamate	estimate
afuectionly	affectionately
gess	grass
custamry	customary
comfort	comfortable
nore*2	nor
infoseason	enthusiasm
rexemindiation	recommendation
whisle	whistling
enoyance	annoyance
defie	defy
connectivies	connectives
durn	done
fiel	phial
thourally	thoroughly
mooey	money
estabishments	establishments
beatful	beautiful
fact	fight
ackquaintance	acquaintance
rechond	reckon
aspeat	aspect
dinned	dinner
rond	around
acheve	achieve
reduckulies	ridiculous
stamoch	stomach
annuncio	announce
aduoteriam	auditorium
atipicatience	anticipation
femilure	familiar
morgare	mortgage
excratrate	exaggerate
counicl	counsel
operset	opposite
soronded	surrounded
priliminary	preliminary
neibour	neighbour
apprent	apparent
civilations	civilizations
culu	cultures
anticipating	anticipation
seast	cease
permonet	permanent
efect	effect
stisicks	statistics
acnoledgement	acknowledgement
sefures	surface
grape	groups
arithmatic	arithmetic
potatas	potatoes
foundimental	fundamental
costomor's	customer's
misdameanor	misdemeanor
cusonary	customary
pricishant	precision
droppted	dropped
teknical	technical
tint	thin
stumuke	stomach
anticepation	anticipation
inmenly	immediately
apparately	apparently
hier	higher
before_hand	beforehand
lory*7	lorry
arwser	answer
imederalte	immediately
deemn	deem
gurantte	guarantee
rediculeous	ridiculous
houe	house
gardin	guardian
Tow	Two
occasionily	occasionally
tiad	tied
conceave	conceive
gratuelly	gradually
rohit	wrote
rase	raise
machane	machine
intregued	intrigued
coverterly	comfortable
alowe	above
dizined	designed
converlescence	convalescence
principuls	principles
effect	affect
atcating	attaching
aser	answer
regwesting	requesting
elamentry	elementary
pitty	pity
interested	interest
gavepe	galloped
smiwing	swimming
permananty	permanently
gurriden	guardian
rhumitism	rheumatism
indefinte	indefinite
favoerable	favourable
pregidess	prejudice
go	get
one	once
romanitic	romantic
menloncholy	melancholy
extraordonary	extraordinary
wimmin	women
iristable	irresistible
siege	cease
fretrunly	fraternally
ensitable	irresistible
omniverously	omnivorously
frescoes	frescos
fleash	flesh
alttemeter	altimeter
miterialy	materially
anonimity	anonymity
inrestable	irresistible
tecinacal	technical
emidiately	immediately
prelemary	preliminary
aner	any
girl_friend	girlfriend
nale	nail
fird	fight
projets	projects
polimernery	preliminary
insted	instead
necesscay	necessary
opperation	operation
ruemitisium	rheumatism
leterally	literally
excitment	excitement
bisycal	bicycle
morgh	mortgage
speeling	spelling
semblys	assemblies
inthsiatem	enthusiasm
chairmen	chairman
egsistence*2	existence
Enemy	enemy
estemend	esteemed
labatory	laboratory
salte	certainly
magnifficent	magnificent
flangraney	flagrancy
mooe	more
propem	problem
opod	opened
sicollege	psychology
hierachial	hierarchical
spirituall	spiritual
tmera	temperature
recquired*2	required
extronary	extraordinary
nosl	noisy
toght	trotting
nessary	necessary
math-matics	mathematics
choose	chose
imthustic	enthusiastic
customers'	customer's
particile	partial
misdemenor	misdemeanour
agoin	again
coming	came
enquir	enquire
dowr	draw
cirtain	certain
leede	leeds
cansled	cancelled
when*2	went
nath	knife
aoteod	altitude
vacancieces	vacancies
intal	until
all-ready	all_right
wucde	walked
itemize	itemized
basects	basic
murmer	murmur
thourght	taught
apprortiate	appropriate
breeth	breathe
promist	promised
ruen	ruin
aswell	as_well
append	opened
atmospher	atmosphere
theroughly	thoroughly
shrority	sorority
teleponed	telephoned
allumi	alumni
fiynalle	financial
availieble	available
dicretion	discretion
hande	hand
courieous	curious
rermember	remember
butefull	beautiful
in	even
colbe	club
a_specally*2	especially
projoc	project
deleckwod	delinquent
fers	furs
effienicy	efficiency
aeplan	aeroplane
shear	share
penitentary	penitentiary
sitistics	statistics
will	well
wile	wild
sutnly	certainly
doched	dodged
Im*2	Him
cleaver	clever
humer	humour
contronersery	controversy
hotle	hotel
hunge	hung
athaletics	athletics
suiterbly	suitable
antesipation	anticipation
beat	best
wery	weary
monestaries	monasteries
invlving	involving
aprovely	approval
galvunize	galvanized
exspted	experts
colarteroul	collateral
bifull	beautiful
distingush	distinguish
mathmetics	mathematics
recepient	recipient
imeadely	immediately
wen*3	when
hower	having
remerbor	remember
insance	instance
spirt	spiritual
splanted	splendid
ininconveniences	inconvenience
hidon	hidden
disingned	designed
conquerer	conqueror
terrec	traffic
undoubtly	undoubtedly
ungletevel	unforgettable
through	throw
fluctuations	fluctuates
critizizem	criticism
inturest	interest
morrgage	mortgage
apologise	apologize
engeneering	engineering
caligraphy	calligraphy
freindly	friendly
ro	row
debett	debit
affidaved	affidavit
subterainam	subterranean
fet	fat
plactine	plasticine
esteened	esteemed
inconvince	inconvenience
rabbies	rabies
heterogenous	heterogeneous
solumn	solemn
dependant*2	dependent
hieyth	height
yous	use
seelor	cellar
mathermatics	mathematics
apay	happy
cach	catch
aneser	answer
appraoch	approach
courtisum	criticism
aurses	answer
contende	contented
ever	every
indeffinate	indefinitely
thorughly	thoroughly
housepoints	house_points
trealh	breathe
carred	crowded
Rolateral	collateral
intillectual	intellectual
textle	technical
opersit	opposite
frternelly	fraternally
aquantaince	acquaintance
destinct	distinct
concieous	conscious
aproal	approval
rome	rooms
ah	a
aroude	around
pantrey	pantry
ore	or
afued	avoid
tedt	turned
weich	which
vinagarette	vinaigrette
elimate	eliminate
spere	spear
ramll	scrambled
phipiolog	philosophy
mutunal	mutual
lae	lay
critisisim	criticism
anparelle	unparalleled
anxios	anxious
oportunities	opportunities
pac	pockets
filousfy	philosophy
spiritul	spiritual
cour	curiosity
a_sleep*2	asleep
idealy	ideally
line	lines
Mr's	Mrs
supession	suspicion
wirting	writing
cementray	cemetery
worthwile	worthwhile
illimenate	eliminate
decided	decide
sherif	sheriff
economics	economical
poure	poetry
blow	blue
silfely	skilfully
tryamph	triumph
souen	southern
th	to
monitary	monetary
undovt	undoubtedly
diches	dishes
equpet	equipped
initation*2	initiation
spohal	special
thing	things
ocrces	orchestra
wark	work
fundementle	fundamental
aturny	attorney
adjurden	adjourned
airaear	area
discresione	discretion
openend	opened
acording*2	according
galope	galloped
reckamentation	recommendations
emmecialy	immensely
character	characters
uninployd	unemployed
taked	talked
cunage	tonnage
trillby	trilby
hole	who
rouns	rounds
axed	accident
delicuant	delinquent
ferman	firms
cauler	caller
Showtalkaw	Chautauqua
enourmously	enormously
abowt	about
subterain	subterranean
oul	owl
enthoseasem	enthusiasm
foke	folk
fincancers	financiers
sweetes	sweetest
incovinent	inconvenient
cloak_rooms	cloakrooms
sepemends	specimens
isten	isn't
thero	thorough
remer	remember
supacificly	specifically
vanciety	vacancy
afection	affection
mel	meal
werd	weird
oppost	opposite
c_pmasterly	capacity
fundanental	fundamental
net	that
giveing	giving
enviromentalist	environmentalist
sout	sort
loco	local
costomrey	customary
accomponing	accompanying
attache	attaching
literitally	literally
yew	you
bease	because
cortios	courteous
ecception	exception
searsly	scarcely
hreb	here
skellfortly	skilfully
transfured	transferred
ubiquitious	ubiquitous
tripe	trip
mremrany	primary
discite	discrete
metlry	materially
dishings	distinguished
visility	facilities
effectionally	affectionately
forer	four
acheived*2	achieved
curten	curtains
affectconley	affectionately
indefinaly	indefinitely
spaisile	special
sus	sons
magnifet	magnificent
reconemdation	recommendation
loger	longer
attching	attaching
satisfacshoin	satisfaction
fracksy	flagrancy
exponentualy	exponentially
yousel	usually
pamphalets	pamphlets
a_nougth	enough
ballance	balance
authobiography	autobiography
undesland	understand
spang	spinning
whereever*2	wherever
luf	laugh
cheon	children
aucastle	orchestra
altidud	altitude
analagous*2	analogous
amatuer	amateur
birden	burden
approiximate	approximate
anganally	originally
cancell	cancel
faily	fairly
conciouas	conscientious
corsing	causing
resaise	resource
impractible	impracticable
cataloguin	cataloguing
infact*2	in_fact
colect	collect
rebarter	reporter
espally	especially
diffinetly	definitely
dagmed	damaged
viseted	visited
Chataukwa	Chautauqua
cannisters	canisters
skert	skirt
dizsand	designed
agravate	aggravate
fenering	fight
beathe	breathe
gregrated	regretted
exition	exhibition
mountiess	mountainous
surfishiat	sufficient
spase_cruft	spacecraft
expaned	explained
appoching	approaching
garunteed	guaranteed
metalurgical	metallurgical
purlmily	preliminary
countantiance	countenance
consiquence	consequence
apserved	absurd
apprentiship	apprenticeship
deluncious	delinquent
agregates	aggregates
laughes	laughs
breathe	breath
canvious	canvass
debtet	debit
fatd	great
negoitation	negotiations
vaya	vagabond
rectesting	requesting
accostuned	accustomed
sang	shaggy
commuicat	communicate
portent	pretend
polit	pilot
comimittees	committees
discidedly	decidedly
vandand	vagabond
feiwed	viewed
offtan	often
defantnut	definite
hent	hint
brigth	bridge
Presidants'	president's
damdend	damaged
presberitory	presbytery
biscats	biscuits
wart	where
meshien	machine
magneisent	magnificent
facillitys	facilities
ascociation	association
elimentory	elementary
curryous	curious
rules	rulers
skale	scale
predugist	prejudice
Pregidice	prejudice
axcident	accident
mangnicfent	magnificent
rela	real
aply	apply
wiling	willing
weute	requesting
sckedual	schedule
less	leeds
appertentaly	apparently
maner	manner
symphtic	sympathetic
suficiant	sufficient
occurance*2	occurrence
inconvienances	inconvenience
garden	guardian
symettrical	symmetrical
metalurgic	metallurgic
tesded	touched
stolon	stolen
troups	troupes
abord	avoid
alright*2	all_right
serat	city
termanent	tournament
refreshmernt	refreshment
supteranion	subterranean
misalanius	miscellaneous
indifinently	indefinitely
dunt	dart
asemnly	assembly
to-days	to-day's
flosphey	philosophy
apxormanately	approximately
sickoligy	psychology
frite	fight
enthinastic	enthusiastic
seacly	scarcely
camploft	pamphlet
turall_ran	trial-run
unparale	unparalleled
duit	dart
alockments	allotment
met	me
dome	done
exiting	exciting
unconviced	unconvinced
effecience	efficiency
estableshing	establishing
hair_dressing	hairdressing
Volgor	vulgar
connsious	conscious
seiced	seized
micsoulanous	miscellaneous
phisolay	philosophy
Romantic	romantic
other_wise*3	otherwise
strue	stars
resarce	resource
parenthasis	parenthesis
part_time	part-time
servis	surplus
philophsophy	philosophy
simulated	stimulated
curculing	circling
whisling	whistling
favorate	favourite
envieseasem	enthusiasm
gag	gauge
veroes	various
Phonia	pneumonia
unacsesible	inaccessible
seser	saucer
tragedity	tragedy
recemend	recommend
iterment	instruments
practacing	practising
betifull	beautiful
enthesyastic	enthusiastic
ch	cochlea
angisity	anxiety
accationally	occasionally
avenge	avoid
privilages	privileges
ansir	answer
micely	nicely
desinden	designed
suitible	suitable
walk	walks
oftain	often
fiend	friend
daubt	doubt
sim	seem
lot	lots
curcer	curtains
cancelation	cancelling
daye	dangerous
in_fisenasen	enthusiasm
drewe	drew
a_meckle	immediately
ceased	seized
eficiciency	efficiency
szeid	seized
garuantee	guarantee
deanned	deem
frizzing	freezing
rolld	rolled
afthe	after
becom	become
wheel_barrow	wheelbarrow
garenttee	guarantee
bite	belt
desgined	designed
equped	equipped
begaining	beginning
bone	done
deturmand	determined
distanctly	distinctly
lot	a_lot
epelton	equipped
shucking	shaggy
entheseusem	enthusiasm
troblernsom	troublesome
garge	gauge
consiencess	conscientious
forseeable	foreseeable
anerser	answer
expeshley	especially
wonder	women
wowd	women
incedantally	incidentally
distrect	district
rebers	repairs
part-eclipse	partial_eclipse
farolc	traffic
askedent	accident
my	the
optition	optician
maknivson	splendid
weght	weight
pneumunia	pneumonia
echwelly	equally
tride	tried
unberstand	understand
magnicsend	magnificent
formost	foremost
harras	harass
conetisons	conditions
batallion*2	battalion
hertbreake	heartbreak
pilet	pilot's
mond	monday
can	catch
venturlated	ventilated
puyms	poems
biger*2	bigger
deftinately	definitely
woke	work
increasinly	increasingly
suffecienly	sufficiently
enters	entrance
collonies	colonies
seepping	spinning
incorperation	incorporation
lows	loose
episuple	epistle
neigbour*2	neighbour
confortable	comfortable
exsagurate	exaggerate
macnifcent	magnificent
reticuous	ridiculous
berfore	before
critici	criticism
apperatos	apparatus
predijice	prejudice
mountainees	mountainous
oppratorate	appropriate
surrouded	surrounded
deformaty	deformity
premonitly	permanently
attiching	attaching
troten	trotting
sledid	splendid
esteamed	esteemed
a'er	ere
enitionation	initiation
recrisition	requisition
aggentecies	agencies
enthusian	enthusiasm
corradul	collateral
comfentenl	comfortable
exqueste	exquisite
tourimant	tournament
ills	curtains
towords	towards
beautyful	beautiful
guarrottee	guarantee
seatized	seized
tecknical	technical
exsadurat	exaggerate
wreack	wreck
cholep	called
mieums	museums
geomotry	geometry
exeptionally	exceptionally
queit	quite
pur	pure
absurb	absurd
probalum	problem
verterue	virtue
bankrupercy	bankruptcy
finuls	final
voteing	voting
sclfoly	skilfully
practicioners	practitioners
critizition	criticism
buildt	built
satisfactonly	satisfactorily
equifly	equally
controled*2	controlled
stenious	strenuous
feture	feature
fery	ferry
indefinat	indefinite
has	heard
steirly	scarcely
seacuse	cease
us_aselly	especially
comptant	competent
there	these
controversey	controversy
cpn	captain
postoffice	post_office
costomery	customary
repairation	reparation
exceptionaly	exceptionally
pression	precision
tempratur	temperature
twen	twin
personalert	personality
skiverly	skilfully
letter	later
brakes	breaks
highdrawrick	hydraulic
kernal	colonel
dred	dread
pnenomionia	pneumonia
perseverence	perseverance
anniversay	anniversary
foucher	voucher
nocked	knocked
hydrawlick	hydraulic
ladh*2	laid
greive*2	grieve
imation	imitation
daders	dangerous
grage	gradually
berg	beg
countel	council
temperary	temporary
inconiven	inconvenient
buttd	beautiful
panfalit	pamphlet
ettalared	altitude
regurne	region
techinal	technical
excecute	execute
regjen	region
waud	wonder
faxe	fax
eminsily	immensely
remane	remain
polits	pilot's
politition	politician
effectinly	affectionately
dormortory	dormitory
garent	guarantee
customars	customer's
literial	literally
missalaneis	miscellaneous
head-master	headmaster
frighatend	frightened
exgistance	existence
sisors	scissors
imigrant	emigrant
persichion	precision
tech	teach
equasion	equation
sackreligious	sacrilegious
fright	fight
memanpies	memorandum
vacanous	vacancies
tradgy	tragedy
gauadian	guardian
shab	shaggy
satlistash	satisfaction
in_strement	instruments
rab	rob
pased	passed
aventually	eventually
pepo	people
devide*2	divide
redgeisdes	prejudice
conceintious	conscientious
eclispe	eclipse
acshorly	actually
crosing	crossing
courtiesies	courtesies
head_master	headmaster's
beuitful	beautiful
tape_recorder	tape-recorder
behaver	behaviour
Catalogs	catalogues
sunent	sons
accostumed	accustomed
anscious	anxious
exsample	example
tulls	choose
enthousiasum	enthusiasm
Shautalkwa	Chautauqua
Crist	Christ
eniticion	initiation
essals	easels
siting*3	sitting
coidisions	conditions
exsstants	existence
Perminately	permanently
nat	not
manobrandom	memorandum
festinating	fascinating
occompanying	accompanying
minnimium	minimum
exwiset	exquisite
drinks	juice
vagacy	vagabond
musiem	museum
friezeing	freezing
bridg	bridge
attacked	attached
lorb	loud
enyays	enjoys
comdash	accomplished
inacesesible	inaccessible
equley	equally
vacantcy	vacancies
Ghandi	Gandhi
be	beginning
refergator	refrigerator
doll	dull
filld	filled
geomtry	geometry
visuble	visible
carronteed	guarantee
supision	suspicion
spicial	special
anxioty	anxiety
provid	provide
alledge	allege
atstablishing	establishing
siniture	signature
calateral	collateral
dratras	dangerous
poilice	police
sall	sell
sypathtic	sympathetic
disippate*2	dissipate
armar	altimeter
stearing	staring
cheeper	cheaper
chiking	chickens
frignd	be_frightened
liv	live
aimiably	amiable
carachter	character
inconvenients	inconvenienced
ficticious	fictitious
travell	travel
familier	familiar
analasys	analysis
instal	install
falgrncy	flagrancy
tope	chop
annalizes	analysis
proloame	prologue
kingdegatern	kindergarten
accknowlegment	acknowledgement
thess	these
contempible	contemptible
memey	many
evey_bod	everybody
extheordinary	extraordinary
boulder	vulgar
extorandory	extraordinary
fratrunaly	fraternally
commtied	committed
Adam	Adam's
aer	our
recond	reckon
happie	happy
plimmernary	preliminary
alumnae	alumni
inconvenice	inconvenience
anuaual	annual
afftadave	affidavit
crat	trap
refrastment	refreshment
them*2	then
secion	section
autatorom	auditorium
skilfarly	skilfully
dests	desks
daimond	diamond
kingergarton	kindergarten
aet	ate
shichis	stitches
palte	pilot
colataral	collateral
inconfience	inconvenience
arownd	around
acuatly	actually
statistory	satisfactorily
lawer	lawyer
refridguator	refrigerator
sypathetic	sympathetic
occurrance	occurrence
descrettion	discretion
reciently	recently
refiring	referring
presidents'	president's
orchestre	orchestra
dammage	damaged
anyelsis	analysis
arangments	arrangements
infanent	infinite
estsablishing	establishing
gourgace	gorgeous
satisfactoin	satisfaction
imphasiasm	enthusiasm
noun	name
indefinate	indefinite
chane	chain
agression	aggression
buillton	bulletin
ordinonaly	ordinarily
vertuse	virtues
unaimous	unanimous
equunte	equipped
anthouasem	enthusiasm
substeranium	subterranean
police_man*6	policeman
incefecient	incidentally
Franch	French
Japannese	Japanese
econalical	economical
reckcomended	recommended
howeverr	however
know*4	no
leve*2	leave
anivesery	anniversary
matrial	materially
for	form
inconvinance	inconvenience
benificial*2	beneficial
asurtaine	ascertain
surroned	surrounded
visibale	visible
disighed	designed
blackcurrents	blackcurrants
this	his
enthuans	enthusiasm
metropolitian	metropolitan
nat	mat
pip	pipe
idividualistic	individualistic
apperance	appearance
annointed	anointed
nei	any
skillferly	skilfully
endetf	earth
exci	exists
injury	enjoy
simpercity	sympathetic
breaktime	break_time
predjudice	prejudice
acreued	accrued
pounia	pneumonia
sovereignity	sovereignty
pratically	practically
pregnent	pregnant
wick	woke
decedaly	decidedly
chataque	Chautauqua
anella	analysis
spiy	spy
volfure	voucher
soverignity	sovereignty
enthuseasam	enthusiasm
alot	allot
piltea	pilot
conte	contented
visted	visited
Hitlar	Hitler
apropate	appropriate
bongulo	bungalow
inconvenced	inconvenienced
Ecomonical	economical
acordance	accordance
requsion	requisition
exibtion	exhibition
inishiation	initiation
ralway	railway
certens	curtains
surfdom	serfdom
defaully	definitely
to	about
margage	mortgage
reuathism	rheumatism
conscienceness	conscience
cartaker	caretaker
dosen	dozen
Fiyer	Fire
cymitery	symmetry
loast	lost
vicitet	visited
theridically	theoretical
anbrassed	embarrassed
poum	poems
seventen	seventeen
cycoligaty	psychology
similiarity	similarity
romatics	romantic
with_aot	without
wreck	rec
Stranden	Stranded
potery	pottery
teckniqual	technical
correspondents	correspondence
doromortory	dormitory
stongly	strongly
eassier	easier
gorgus	gorgeous
altermetor	altimeter
bek	back
inconvenent	inconvenient
shebre	Sheba
yoy	why
recomondening	recommending
afectoinly	affectionately
acheivments	achievements
heros	heroes
analoyas	analysis
concienitous	conscientious
hicocter	helicopter
intersede	intercede
enthusiast	enthusiastic
eaquly	equally
find*2	fine
tenacle	tentacle
northereastern	northeastern
pokects	pockets
avode	avoid
setinly	certainly
presious	precious
archaology	archeology
rhematism	rheumatism
vouncher	voucher
atmosfere	atmosphere
ajurened	adjourned
leteralaly	literally
appromaxiately	approximately
preduous	prejudice
immidately*2	immediately
thats*10	that's
permanentley	permanently
maloncolly	melancholy
hypotathese	hypothesis
ininsit	innocent
anable	enable
jumper	jumped
enviornment	environment
la	lay
untideness	untidiness
eccnomics	economics
pilts	pilot's
kintergarten	kindergarten
dicovering	discovering
nucleur	nuclear
Tusday	Tuesday
vitures	virtues
odened	opened
annima	annum
picificly	specifically
saten	satin
previlidge	privilege
afful	awful
primerly	preliminary
scapping	scraping
contrefercing	controversy
nousey	noisy
unmistakeable	unmistakable
sother	southern
miscolaneous	miscellaneous
contiencious	conscientious
hope	happy
curriousity	curiosity
reciprocel	reciprocal
ersistable	irresistible
sicorrs	scissors
acknoledging	acknowledging
hachess	hatches
every_body	everybody
ancs	anxious
thng	thing
subsiquent	subsequent
delient	delinquent
rain_coats	raincoats
vaulger	vulgar
wet	would
aprocamate	approximate
interpart	interpretation
dark	back
specament	specimen
fundimental	fundamental
coolaterial	collateral
inactessable	inaccessible
neccesity	necessity
misatainess	miscellaneous
diamater	diameter
differnt	different
unfergetable	unforgettable
flukse	flux
dund	done
imanent	imminent
bister	best
neednot	need_not
awrost	dinner
thorally	thoroughly
propogates	propagates
villin	villein
annouance	annoyance
vistid	visited
def	devices
hire	higher
polititon	politician
guarented	guaranteed
schuedule	scheduled
parteners	partners
transcendance	transcendence
ade	add
onniver	anniversary
facountcy	vacancy
anhour	an_hour
live	life
bus	bridge
restictive	restrictive
waching	washing
advalbal	available
sacrellergeous	sacrilegious
definate*3	definite
refidualetor	refrigerator
fere	very
accension	accession
nosey	noisy
comfortble	comfortable
udoubtly	undoubtedly
triping	tripping
amplying	alpine
anxiaty	anxiety
outpen	alpine
esadend	accident
rehomatic	romantic
a_spast	especially
aechd	aged
epitol	epistle
tecln	technologically
distingish	distinguish
unfortnate	unfortunate
dangearos	dangerous
acellerate	accelerate
reasen	recently
ower	our
vurtutes	virtues
sant	sent
copping	coping
thracant	tracksuit
antiscipation	anticipation
herslef	herself
cierciling	circling
tighting	tightening
financhial	financial
evaualtion	evaluation
comitte	committee
consents	conscience
jenius	genius
gripe	grip
extesy	ecstasy
posesses	possess
shur	sure
dissobediance	disobedience
lief	life
tommorrow*4	tomorrow
dodeged	dodged
prediges	prejudice
anythin	anything
fount	found
aproxmentally	approximately
poletree	poultry
hedg	hedge
cifye	city
shog	shaggy
philipinoes	filipinos
foot-ball	football
altitube	altitude
soshger	searched
glass-rooms	classrooms
torrment	tournament
spear	spare
poshr	poems
unterned	unturned
iconvinent	inconvenient
micellaneous	miscellaneous
proceedual	procedure
bawd	bored
wond	wonder
orgin	origin
irisible	irresistible
stomc	stomach
consummer	consumer
representitives	representatives
apperatas	apparatus
ecomonicts	economics
fied	fire
prire	prior
clos_room	classrooms
fie	fly
revinue	revenue
soleum	solemn
shool*2	school
staisfactorally	satisfactorily
esolainious	miscellaneous
alumie	alumni
lodge	hedge
w	you
appromexally	approximately
ke	key
consitutional	constitutional
desetain	destination
enitial	initial
hiar	here
couse	cause
yore	your
sheat	sheath
occasionly	occasionally
threshhold	threshold
nosiey	noisy
cripe	grippe
blow*3	blew
animan	annum
misernanery	miscellaneous
satisfatch	satisfaction
graguly	gradually
kame	came
President	president's
canselution	cancellation
disappiont	disappoint
excecutes	executes
seiged	seized
inconvienence	inconvenienced
embaressed	embarrassed
recommeded	recommended
bibble	bible
beefore	before
approckmate	approximate
fome	from
troup	troop
survay	survey
refemt	refreshment
sertly	certainly
execesses	exists
begen	begun
refrigeator	refrigerator
thorugh	thought
ussually	usually
outamenter	altimeter
splender	splendid
astertain	ascertain
differed	different
temperory	temporary
shutched	searched
sars	stars
legeslature	legislature
sypathic	sympathetic
expalin	explain
encovience	inconvenience
experimet	apparatus
as	us
pimaly	preliminary
vieded	viewed
initihls	initials
spainish	Spanish
annallasis	analysis
preet	pretend
acieved	achieved
reafe	relief
peices	pieces
eva	even
suracaty	sorority
misdemenors	misdemeanors
luckly	luckily
mancificent	magnificent
latestest	latest
shouldnt	shouldn't
prok	pork
paking	packing
grip	grippe
sacraligious	sacrilegious
for	flying
temporately	temporarily
bisycle	bicycle
recenly	recently
bime	belt
finially	finally
verfication	verification
bauthful	beautiful
satishfacen	satisfaction
connecton	connection
proceture	procedure
anisaty	anxiety
refigorator	refrigerator
recmition	recognition
satruligd	sacrilegious
afidavite	affidavit
tequniques	techniques
behaviour	behavior
ceratin	certain
other*3	others
trymth	triumph
feue	fight
yousto	used_to
absurded	absurd
orrigh	alright
delvin	delving
thorouly	thoroughly
avalable*2	available
pepall	people
congraduation	congratulations
proceeder	procedure
actioally	actually
Ensysastic	enthusiastic
coffer	coffee
plebian	plebeian
as	actually
comander	commander
gitting	getting
affestionatly	affectionately
parrald	parallel
scc	scientists
courtiseses	courtesies
cta	sit
tecknal	technical
plom	plum
eazily	easily
flam	flame
picture*2	pictures
semi_permanantly	semi-permanently
fairy	ferry
propoganda	propaganda
ownes	owns
procedier	procedure
polotician	politician
griticism	criticism
primicples	principles
pire	prior
coots	coats
mystry	mystery
under_a_asst	unforgettable
surruptitiously	surreptitiously
persueing	pursuing
fivty	fifty
iland	island
pht	put
lerans	learns
deffinently	definitely
lable	label
asociation	association
tibe	type
rediclous	ridiculous
Statics	statistics
govermont	government
nintieth	ninetieth
strenouous	strenuous
wholy	holy
physian	physician
waying	weighing
rigth*3	right
associate	associate
audortorium	auditorium
graps	grapes
certuse	courteous
recive	receiving
livlihood	livelihood
gloweld	glowed
leafe	leaf
stratagy	strategy
easy	easier
rheumitizm	rheumatism
moutle	mutual
instatance	instance
thorly	thoroughly
originaly*2	originally
volture	voucher
speciemens	specimens
wanna	want_to
harcent	accident
sind	said
swim	swimming
scheudaled	scheduled
discoverd	discovered
economtric	econometric
aheard	ahead
aire	ere
apertunities	opportunities
boad	belt
saddel	saddle
anxioss	anxious
commitee*3	committee
woild	would
unemployed	unemployed
upbuve	above
amenable	amiable
negotations	negotiations
hagee	edge
anoines	annoyance
entrens	entrance
rococco	rococo
relf	relief
repair	repairs
distination	destination
d	be
endebinit	indefinite
suport	support
ininblid	unemployed
sedent	accident
please	phase
pese	piece
gert	great
when	we
consempation	conception
momarandom	memorandum
hark	hawk
sizes	cease
refreashment	refreshment
basball	baseball
courtcies	courtesy
fromed	formed
serverly	severely
taafic	traffic
pregidus	prejudice
angzietay	anxiety
wilking	walking
pictureesks	picturesque
increasi	increase
chasr	chaser
pemanent	permanent
miesalanias	miscellaneous
providge	privilege
pschicology	psychology
endiffinate-	indefinite
afectionaly	affectionately
imploy	employ
graly	gradually
conscienscious	conscientious
prcision	precision
truthfall	truthfully
apparinately	apparently
whated*2	wanted
quizes*2	quizzes
micellanous	miscellaneous
clos	close
scheudel	schedule
hvea	have
effection	affectionate
arigode	avoid
notsod	removed
whey	were
enmies	enemies
echomnic	economic
ceeded	seized
lead	leading
ressemble	resemble
ecknowledging	acknowledging
Mean_while	Meanwhile
irrisiterble	irresistible
proscedgor	procedure
defenty	definite
slad	sled
delienquent	delinquent
grined	grind
lessens	lessons
mantain	maintain
conflanes	convalescence
innituation	initiation
mutal	mutual
phsyology	psychology
facitelies	facilities
atheistical	atheistic
pice	pitch
johhn	john
footandmouth	foot-and-mouth
cary	carry
accomodates	accommodates
tackneccal	technical
gareud	gallery
specimins	specimens
suxsesful	successful
erlyer	earlier
learf	laugh
ommissions	omissions
wis	wish
unforunate	unfortunate
pertickly	particularly
wimin	women
stumo	stomach
affivadat	affidavit
indenfient	indefinite
lighting	lightning
expersaly	especially
faciliated	facilitated
coorespondents	correspondence
countriman	countryman
attourney's	attorneys
mesage	message
kees	keys
origanially	originally
enition	initiation
large	larger
exis	exists
caben	cabin
debted	debit
than	and
acwiped	equipped
pirlet	pilot
primarly	primary
ledser	leisure
arow	arrow
beith	breathe
thy	they
exibison	exhibition
potates*2	potatoes
doubb	doubtless
oppiset	opposite
onw	own
effeciance	efficiency
voughture	voucher
exsepilay	exceptionally
breif	brief
indeffantly	indefinitely
predgice	prejudice
sucesion	succession
corridoored	corridored
sicology	psychology
knowlede	knowledge
encouraged	encouraging
wagon*3	waggon
harrised	harassed
idmitized	itemized
famliy	family
necessarely	necessarily
dormiltory	dormitory
fadies	phase
pecualer	peculiar
bankrupicy	bankruptcy
establicin	establishing
stationery	stationary
finol	final
cenetry	chemistry
andtamter	altimeter
atached	attached
be_gening	beginning
circul	circle
quat	quart
bicust	biscuits
adaquate	adequate
countence	countenance
anxouse	anxious
ancios	anxious
recievers	receivers
sain	saying
dron	drawn
reccuring	recurring
farn	frightened
sastisifactory	satisfactorily
beech	beach
restrarant	restaurant
splented	splendid
garlley	gallery
expet's	experts
vagand	vagabond
forwoand	forward
verusete	virtues
deffinity	definitely
menoramden	memorandum
bet	opposite
Chautaqua	Chautauqua
Chatacque	Chautauqua
labority	laboratory
emenys	enemies
unfortuantally	unfortunately
thoes	those
cros	cross
aclateral	collateral
remember	remembrance
memanidal	memorandum
exabison	exhibition
doye	date
enamys	enemies
milke	milk
occassional*2	occasional
curplas	surplus
blas	base
exspelled	expelled
reched	reached
scycallage	psychology
exaduret	exaggerate
start	started
tent	tenth
cone	came
usually	usual
progess	progress
suser	saucer
tree	trees
bigest*2	biggest
inverd	avoid
gad	vagabond
mom	form
aprocsamate	approximate
deafnet	definite
progreing	progressing
indistry	industry
clateral	collateral
compeinent	competent
rinecout	raincoat
dimonds	diamonds
arigale	originally
bet	belt
heart	hurt
alimentary	elementary
capity	capacity
mast	must
recipiant	recipient
whats*3	what's
mithical	mythical
priviliage	privilege
becler	peculiar
terrify's	terrifies
oner	own
serth	surface
sergant	sergeant
countenounce	countenance
ceses	cease
eltitude	altitude
acoumpish	accomplished
taining	training
ecomonices	economics
petetion	petition
custormester	customer's
tenper	temper
agenticies	agencies
cereer	courses
shore*3	sure
upat	half_past
mischevious	mischievous
opset	opposite
quitely*2	quietly
raly	really
accomadated	accommodated
conveinently	conveniently
eniceation	initiation
poil	pilot
confusin	confusing
spicemens	specimens
idmized	itemized
mear*2	mere
Apprentiship	Apprenticeship
strinious	strenuous
occasonaly	occasionally
chatauchuia	Chautauqua
stitictics	statistics
sirfis	surface
galvantized	galvanized
entham	enthusiasm
discpline	discipline
determin	determine
hones	house
enconble	economical
along	a_long
